0 0 0 0 0 0 0 0 0 0 0 0 0 0 0 0
0 0 0 0 0 0 0 0 0 0 0 4 0 0 0 0
0 0 0 0 0 0 0 0 2 2 2 4 0 0 0 0
0 0 0 0 0 0 0 0 3 3 3 4 0 0 0 0
0 0 0 0 0 0 0 0 0 0 0 0 0 0 0 0
0 0 0 0 0 0 0 0 0 0 0 0 0 0 0 0
0 0 0 0 0 0 0 0 0 0 0 0 0 0 0 0
0 0 0 0 0 0 0 0 0 0 0 0 0 4 4 0
0 1 0 0 0 0 0 0 0 0 4 3 5 5 1 0
0 1 0 0 0 0 0 0 0 0 4 3 5 5 1 0
0 1 2 4 0 0 0 0 0 0 4 3 3 5 1 0
0 1 2 4 0 0 0 0 0 0 4 3 3 3 3 0