11 11 11 11 11 11 11 11 11 11 11 11 11 11 11 11 11 11 11 11 11 11 11 11 11 11 11 11 11 11 11 11 11 11 11 11 11 11 11 11 11 11 11 11 11 11 11 11 11 11 11 11 11 11 11 11 11 11 11 11 11 11 11 11 11 11 11 11 11 11 11 11 11 11 11 11 11 11 11 11 11 11 11 11 11 11 11 11 11 11 11 11 11 11 11 11 11 11 11 11 
11 16 16 16 16 16 16 16 16 16 16 16 16 16 16 16 16 16 16 16 16 16 10 10 10 10 10 10 2 10 10 10 20 21 21 21 21 21 21 21 21 21 21 21 21 21 21 21 22 10 10 10 10 2 2 2 10 10 10 10 2 10 10 23 13 19 13 19 13 13 19 13 47 52 52 43 43 53 53 46 13 13 13 13 13 13 13 13 13 13 13 13 13 13 13 13 47 43 53 11 
11 16 16 16 16 16 16 16 16 16 16 16 16 16 16 16 16 16 16 16 16 16 10 10 10 10 2 2 2 10 10 10 25 26 19 13 19 13 13 13 13 19 13 19 13 19 13 19 24 10 10 10 2 2 10 10 16 16 2 10 10 10 10 23 13 13 13 13 13 19 13 13 47 52 52 43 43 53 53 46 13 13 13 19 13 13 13 19 13 13 13 19 13 19 13 13 47 43 43 11 
11 16 16 16 10 10 10 12 1 1 1 1 18 10 10 2 10 16 16 16 16 16 16 10 10 10 10 2 10 10 10 10 10 10 25 29 13 13 19 13 19 13 13 19 13 13 13 13 24 10 10 2 10 2 2 16 10 2 2 10 10 2 10 23 13 19 13 13 13 13 13 13 47 53 52 43 43 52 53 46 13 13 13 13 13 19 13 13 13 19 13 13 13 13 19 13 47 43 43 11 
11 16 16 16 10 10 10 8 3 3 3 3 7 10 2 16 2 10 16 16 16 16 16 16 16 10 10 2 2 2 10 10 10 10 10 23 13 19 13 13 13 13 13 13 13 13 19 13 24 10 10 10 10 2 10 10 10 2 16 10 10 10 10 23 13 13 13 19 13 13 19 13 47 43 43 43 43 43 43 46 13 13 13 13 13 13 13 19 13 13 19 13 13 19 13 13 47 43 53 11 
11 16 16 16 10 10 10 8 3 3 3 3 7 10 2 10 10 2 10 16 16 16 16 16 16 16 16 2 10 10 10 10 10 10 10 25 26 26 26 26 26 26 26 26 26 26 26 26 27 10 10 2 10 10 2 10 10 16 16 10 10 10 10 23 13 19 13 13 13 13 13 13 47 43 43 52 43 43 43 46 13 13 19 13 13 19 13 13 13 13 13 13 13 13 13 13 47 43 43 11 
11 16 16 16 10 10 2 8 3 3 3 3 7 10 10 10 2 10 10 10 16 16 16 16 16 16 16 2 10 10 10 10 10 10 10 10 10 10 10 16 10 10 16 10 16 10 10 16 10 10 16 16 10 10 2 2 10 10 10 10 10 2 16 23 13 13 13 13 19 13 13 13 47 43 43 43 43 43 43 43 48 13 13 13 13 13 19 13 19 13 13 50 44 44 44 44 43 43 43 11 
11 16 16 16 10 16 2 8 3 3 3 3 7 2 10 10 10 10 10 10 10 16 16 16 16 16 16 2 10 10 10 10 10 10 10 10 10 10 10 10 10 10 10 10 10 10 10 10 10 10 16 2 10 10 10 10 10 10 10 10 10 10 10 23 13 19 13 13 13 13 13 13 47 43 53 52 43 43 43 43 46 13 13 13 13 13 13 13 13 13 13 47 43 43 43 43 52 53 43 11 
11 16 16 16 10 10 10 14 6 3 3 4 15 10 10 10 10 10 10 10 10 10 16 16 16 16 16 10 10 10 2 10 10 10 10 10 10 10 16 10 16 10 10 16 10 10 2 10 2 10 16 10 16 16 2 10 10 10 20 21 22 10 10 23 13 13 13 13 19 13 19 13 47 43 52 52 43 43 43 43 43 48 13 13 19 13 13 19 13 13 13 47 43 43 53 43 43 43 43 11 
11 16 16 16 10 10 10 2 8 3 3 7 10 10 10 10 10 2 2 10 10 10 2 10 10 10 10 10 10 10 2 10 10 10 10 10 10 10 10 2 2 10 10 10 10 10 16 10 2 10 10 2 2 10 2 16 10 10 23 19 24 10 10 23 13 13 13 13 13 13 13 13 47 43 43 43 43 43 43 43 43 43 44 44 44 44 44 44 44 44 44 43 43 52 52 43 43 43 43 11 
11 16 16 10 2 10 10 10 8 3 3 7 10 2 2 10 10 2 2 10 10 10 2 2 2 10 10 10 10 2 2 2 10 10 10 10 10 10 2 2 2 2 10 10 2 10 10 10 10 10 2 10 10 10 10 16 2 10 25 29 30 21 22 23 13 19 13 13 13 13 19 13 47 43 43 43 43 43 43 43 43 43 43 43 43 43 43 43 43 43 43 43 43 43 43 43 43 43 43 11 
11 16 16 10 10 10 10 10 8 3 3 7 10 10 10 10 10 10 10 10 10 10 10 10 10 10 2 10 10 2 10 10 10 10 10 2 10 10 10 10 2 10 10 10 16 10 16 10 10 10 2 10 10 2 10 16 2 2 10 25 26 26 27 23 13 13 13 13 19 13 13 13 47 43 43 43 43 43 43 52 43 43 52 52 52 53 43 43 43 43 53 43 43 43 43 43 43 43 43 11 
11 16 16 10 10 10 10 10 10 10 10 10 10 10 10 10 10 10 10 10 10 10 10 10 10 10 10 10 10 10 10 10 10 10 10 2 10 10 10 16 2 2 10 10 10 10 10 10 10 10 10 16 10 10 10 2 10 10 10 10 10 10 10 23 19 13 13 19 13 13 19 13 47 43 52 43 43 43 43 53 43 43 43 43 43 43 43 43 43 43 43 43 43 53 53 52 43 43 43 11 
11 16 16 2 10 10 2 10 10 10 10 10 10 2 10 10 10 10 10 10 2 10 10 10 2 2 10 10 10 10 10 10 10 10 2 2 10 10 10 2 2 10 10 10 2 10 10 16 10 2 2 10 10 10 16 2 10 10 10 2 10 10 10 23 13 13 13 13 13 13 13 13 47 43 43 43 43 43 43 53 43 43 43 43 43 43 43 53 43 43 43 43 43 52 52 43 43 43 43 11 
11 16 10 10 10 10 2 10 10 10 10 10 10 10 10 10 2 10 16 16 10 10 10 10 10 2 10 10 10 10 10 10 10 10 2 2 2 10 16 10 10 16 10 10 10 16 10 10 10 10 10 10 10 10 10 10 10 10 10 10 10 10 2 23 13 19 13 13 19 13 13 13 47 43 43 43 43 43 43 43 43 43 53 43 43 43 43 43 43 43 43 43 43 43 43 43 43 53 43 11 
11 16 2 10 2 10 10 10 10 2 10 10 10 10 10 10 16 16 16 16 10 10 10 10 10 10 10 10 10 10 10 10 10 10 10 10 2 10 2 10 16 10 10 2 10 2 10 10 10 2 10 10 10 10 10 10 10 10 16 10 10 10 16 23 13 13 13 13 13 13 13 19 51 43 43 53 43 43 43 43 43 43 43 43 43 43 43 43 43 43 43 43 43 43 43 43 52 53 43 11 
11 16 10 10 10 10 10 2 10 10 10 10 10 10 10 16 16 16 16 16 10 10 10 10 10 10 10 2 10 10 2 10 10 2 2 10 16 10 16 10 2 2 2 10 10 10 10 10 10 10 10 10 10 2 10 10 10 10 10 10 10 10 10 23 13 19 13 13 13 19 13 13 13 51 43 43 43 43 43 43 43 43 43 43 43 43 43 43 43 43 52 53 53 43 43 43 52 52 43 11 
11 16 16 10 10 16 16 16 16 16 16 16 16 16 16 16 16 16 10 10 2 2 16 10 10 16 10 2 2 16 10 10 16 10 10 10 2 10 10 10 10 2 10 10 10 10 16 10 10 10 2 16 10 10 10 10 10 10 10 10 10 10 10 25 29 13 13 13 13 19 13 13 19 13 51 43 43 52 43 43 43 43 53 52 43 43 53 52 43 43 52 53 53 43 43 43 43 43 43 11 
11 16 16 2 10 16 16 16 16 16 16 16 16 16 16 16 16 16 10 10 10 2 2 10 10 2 10 10 16 16 16 16 16 10 10 16 10 10 10 10 16 10 10 10 16 10 10 10 10 10 10 10 10 10 10 10 10 10 10 10 10 10 10 10 23 19 13 13 13 13 19 13 13 13 13 47 43 43 43 43 43 43 53 52 43 43 52 52 43 43 43 43 43 43 43 43 43 43 43 11 
11 16 16 10 10 16 16 16 16 16 16 16 16 16 16 16 16 16 16 16 10 10 10 10 16 16 16 16 16 16 16 16 16 16 10 10 10 10 16 10 10 10 16 10 10 10 16 10 10 10 10 10 10 10 10 10 10 2 10 10 10 10 10 10 23 13 13 13 19 13 13 13 19 13 13 47 43 43 43 43 43 43 53 53 43 43 52 53 43 43 43 43 43 43 43 43 43 43 43 11 
11 16 16 10 10 10 10 2 10 20 21 21 21 21 21 22 16 16 16 16 16 16 16 16 16 16 16 16 16 16 16 16 16 16 10 10 10 10 10 10 10 10 10 10 2 10 10 10 2 10 10 10 10 10 10 10 10 10 10 10 10 10 10 10 23 13 19 13 13 13 13 13 13 19 13 47 43 52 43 43 43 43 43 43 43 43 43 43 43 43 43 52 52 43 43 43 43 43 43 11 
11 16 16 16 10 2 10 10 10 23 13 13 13 13 13 24 16 16 16 16 16 16 16 16 16 16 16 16 16 16 16 16 16 10 16 10 10 10 10 10 10 10 10 10 10 2 10 10 10 10 10 10 16 10 10 16 10 10 10 10 10 10 10 10 23 13 13 13 19 13 13 19 13 13 13 47 43 43 43 43 53 43 43 43 43 43 43 43 43 43 43 52 52 43 43 43 43 43 43 11 
11 16 16 16 16 10 10 10 20 31 13 13 13 13 13 24 16 16 16 16 16 16 16 16 16 16 16 16 16 16 16 16 16 10 2 10 10 10 10 10 10 10 16 10 10 2 10 10 10 16 10 10 10 10 2 2 2 2 2 2 2 10 10 10 23 19 13 13 13 13 13 13 13 13 13 51 45 45 45 43 43 43 43 43 43 43 52 52 53 53 52 53 52 43 43 43 43 43 43 11 
11 16 16 16 16 2 10 10 23 13 13 13 13 13 13 24 16 16 16 16 16 16 16 16 16 16 16 16 16 16 16 2 2 10 10 10 10 10 10 2 10 2 2 10 10 10 10 10 10 10 10 10 10 10 10 10 10 2 10 10 2 10 10 10 23 13 13 13 19 13 13 13 19 13 19 13 13 13 13 47 43 43 43 43 43 43 43 43 43 53 43 43 43 43 43 43 43 43 43 11 
11 16 16 16 16 10 10 2 23 13 13 13 13 13 13 24 16 16 16 16 16 16 16 16 16 16 16 16 16 2 2 16 10 10 10 10 2 2 10 10 10 10 10 10 10 10 10 10 16 10 10 10 16 10 10 16 2 2 10 10 10 10 10 10 23 19 13 13 13 13 19 13 13 13 13 13 13 19 13 47 43 53 43 43 43 43 43 43 43 43 43 43 43 43 43 43 52 52 43 11 
11 16 16 16 16 16 16 16 23 13 13 13 13 13 13 24 16 16 16 16 16 16 16 16 16 16 16 16 10 10 10 10 10 10 10 10 16 2 10 10 10 10 10 16 10 10 10 2 10 10 10 2 10 10 2 10 10 10 10 2 10 2 10 10 23 13 13 19 13 13 13 13 13 19 13 13 13 13 13 51 43 43 43 43 43 53 43 43 52 43 43 43 43 43 43 43 52 52 43 11 
11 16 16 16 16 16 16 16 23 13 13 13 13 13 13 24 16 16 16 16 16 16 16 16 16 16 16 10 10 10 10 10 10 2 10 10 10 10 10 16 10 10 10 10 2 10 2 2 10 10 10 10 10 2 16 2 10 10 16 2 10 16 10 10 25 26 29 13 13 13 13 13 13 13 13 19 13 13 13 13 51 45 45 45 43 43 43 43 43 43 43 43 52 43 43 43 43 43 43 11 
11 16 16 16 16 16 16 16 25 26 26 26 26 26 26 27 16 16 16 16 16 16 16 16 10 10 10 10 16 10 2 16 10 2 2 2 10 10 10 2 10 16 10 10 10 10 10 10 10 16 2 16 10 10 2 10 10 10 10 2 10 10 10 10 10 10 23 13 19 13 13 19 13 13 13 13 13 19 13 13 13 13 19 13 51 45 45 45 45 45 45 45 45 45 45 45 45 45 45 11 
11 16 16 16 16 16 16 16 16 16 16 16 16 16 16 16 16 16 16 16 16 10 10 10 10 10 10 2 2 2 2 2 10 10 2 2 2 2 2 2 10 10 10 10 10 10 16 10 2 10 10 10 10 10 2 10 10 10 2 10 10 16 10 16 10 2 25 29 13 13 13 13 13 13 13 13 13 13 13 13 13 13 13 13 13 13 13 13 13 13 13 13 13 13 19 13 13 13 19 11 
11 16 16 16 16 16 16 16 16 16 16 16 16 16 16 16 16 16 10 10 10 10 16 2 10 10 10 10 10 2 2 10 2 2 2 2 16 10 10 2 10 10 10 10 10 10 10 10 2 10 10 10 10 10 10 16 10 10 10 2 10 10 10 10 10 10 10 25 29 13 13 13 19 13 13 13 19 13 19 13 13 13 19 13 13 13 13 13 13 13 19 13 13 13 13 13 13 13 13 11 
11 16 16 16 16 16 16 16 16 16 16 16 16 16 16 16 16 16 10 2 10 10 10 10 16 16 10 10 10 16 10 10 2 10 2 2 2 2 10 10 2 10 10 10 10 2 16 10 10 10 10 2 10 10 10 2 2 10 10 10 10 10 10 10 10 10 10 2 25 29 19 13 13 13 19 13 13 13 13 13 19 13 13 13 19 13 13 19 13 13 13 13 19 13 13 19 13 13 13 11 
11 16 16 16 16 16 16 16 16 16 16 16 16 16 16 16 16 16 10 10 10 10 10 10 10 10 10 10 10 10 10 10 2 2 10 10 10 2 10 10 10 10 10 10 10 10 10 2 10 10 16 10 10 10 10 10 10 10 10 10 10 10 10 10 16 10 10 2 2 25 26 26 29 13 13 13 13 13 13 13 13 13 19 13 13 13 13 13 13 13 13 13 13 13 13 13 13 19 13 11 
11 10 10 2 2 10 10 10 10 10 10 2 2 10 10 10 10 10 10 2 10 10 10 10 10 10 10 10 10 10 10 10 10 10 10 16 10 10 10 2 2 2 10 10 10 10 2 10 10 2 10 10 10 10 2 2 10 10 2 16 2 10 10 10 10 10 16 10 10 10 10 10 23 13 13 19 13 13 13 13 13 13 13 13 13 19 13 13 19 13 19 13 13 19 13 13 13 13 13 11 
11 10 2 10 10 10 10 10 10 10 10 10 16 10 10 2 10 2 10 10 16 10 10 16 10 10 10 10 10 16 10 10 10 10 10 10 10 10 2 10 10 10 16 2 10 2 10 10 10 10 10 2 10 10 10 10 10 10 10 2 2 10 10 10 10 10 10 10 10 10 16 10 23 13 13 13 19 13 13 19 13 13 13 13 13 13 13 13 13 13 13 13 13 13 13 13 19 13 13 11 
11 10 10 10 10 10 10 10 10 10 10 10 10 10 10 10 10 10 10 10 10 10 10 10 10 10 10 10 10 16 10 10 2 10 10 10 2 10 10 10 10 10 10 2 10 16 10 10 10 10 10 16 10 10 16 10 2 10 10 10 10 2 10 10 10 10 2 2 10 10 10 10 23 13 13 13 13 13 13 13 13 13 19 13 13 13 19 13 13 13 19 13 13 13 19 13 13 19 13 11 
11 21 21 21 21 21 21 21 21 21 21 21 21 21 21 21 21 21 21 21 41 41 21 21 21 21 21 21 21 21 21 21 21 21 21 21 21 21 21 21 21 21 21 21 21 21 21 21 21 22 2 2 10 16 10 10 2 10 10 10 10 10 10 10 10 10 16 10 10 10 10 10 25 26 26 26 26 26 26 26 26 26 26 26 26 26 26 26 26 26 26 26 26 26 26 26 26 26 26 11 
11 13 19 13 13 13 13 13 13 13 13 13 13 13 13 13 13 13 13 13 41 41 13 13 13 13 13 13 13 13 19 13 13 19 13 13 13 13 13 13 13 13 13 13 13 13 13 13 13 24 16 2 10 2 10 10 2 10 10 10 2 10 10 10 10 10 10 16 10 10 2 2 10 10 10 10 10 10 10 2 2 10 10 10 10 10 10 2 10 10 10 10 10 2 10 10 2 10 10 11 
11 13 13 13 13 19 13 19 19 13 19 13 19 13 19 13 13 13 13 13 41 41 13 19 13 13 13 19 13 13 13 13 19 13 13 13 13 19 13 13 13 13 19 13 13 13 13 13 13 24 10 10 10 10 10 10 10 10 2 2 2 10 16 2 10 10 10 10 10 10 10 10 10 10 10 10 10 10 10 10 10 10 10 10 10 10 10 10 10 10 2 10 16 10 10 10 2 10 10 11 
11 13 13 19 13 13 13 13 13 13 13 13 13 13 13 13 19 13 13 13 41 41 13 13 13 13 13 13 13 13 13 13 13 13 19 13 13 13 13 19 19 13 13 13 13 19 13 13 13 24 10 10 2 10 10 2 10 10 16 10 10 10 16 10 10 2 10 10 10 10 10 10 10 10 10 10 10 10 16 10 2 10 16 10 10 2 10 10 2 10 2 10 10 10 10 10 2 10 10 11 
11 13 19 13 13 13 19 13 13 19 13 13 19 19 13 13 19 13 13 13 41 41 13 13 19 13 19 13 13 13 13 13 19 13 13 13 13 19 13 13 13 19 13 13 13 13 19 13 13 24 16 10 10 10 10 10 10 10 10 2 2 10 10 10 10 2 10 10 10 10 2 2 10 10 10 2 10 10 10 10 2 2 10 10 10 10 10 16 10 10 10 10 10 10 10 10 10 10 10 11 
11 13 19 13 19 13 13 13 13 13 13 13 13 13 13 13 13 19 13 13 41 41 13 19 13 13 13 13 13 19 13 13 13 13 13 13 13 13 13 19 19 13 13 19 13 13 13 13 13 24 10 10 10 10 10 10 10 10 16 10 10 10 2 10 10 2 10 10 10 10 10 10 2 10 10 10 10 16 10 10 10 10 10 10 10 10 10 10 10 10 10 10 10 10 16 10 10 10 10 11 
11 13 13 13 13 13 19 13 13 13 19 13 13 13 19 13 13 19 13 13 41 41 13 13 13 13 19 13 13 13 13 13 13 13 13 13 19 13 13 13 13 13 13 13 13 13 19 13 13 24 10 2 2 16 10 2 2 2 10 2 10 10 10 10 10 10 10 10 10 10 2 10 2 2 10 10 10 10 2 10 10 10 10 10 10 10 10 10 10 10 10 10 10 2 10 10 10 10 10 11 
11 19 13 13 19 13 19 13 19 13 13 13 13 13 13 13 13 13 13 13 41 41 13 13 19 13 13 13 19 13 19 13 13 13 19 13 19 13 13 13 13 13 19 13 13 13 13 13 13 24 10 10 10 10 10 10 10 10 10 10 10 10 10 10 10 10 10 10 10 10 10 2 10 16 10 10 10 10 16 10 10 10 10 10 10 10 2 10 10 10 2 10 2 10 10 10 2 10 10 11 
11 13 13 13 13 13 13 13 13 13 13 19 13 13 19 13 13 13 13 13 41 41 13 19 13 13 13 13 13 13 13 13 13 13 13 13 13 13 13 19 13 13 13 13 19 13 13 13 19 24 10 10 10 10 10 10 10 16 20 21 21 22 10 16 10 10 10 10 10 10 10 10 10 10 16 16 10 10 10 2 10 10 10 16 10 10 2 10 10 10 16 2 10 10 10 10 2 10 10 11 
11 13 13 19 13 13 19 13 19 13 13 13 13 13 13 19 13 19 13 13 41 41 13 13 13 13 13 19 13 13 13 13 13 13 19 13 13 13 13 13 13 19 13 13 13 19 13 13 13 24 10 10 10 10 10 10 10 10 23 13 13 24 2 2 10 10 10 10 10 16 2 10 10 2 10 10 10 16 10 10 10 2 10 10 10 10 2 2 10 2 16 10 10 10 10 10 10 10 10 11 
11 13 13 13 13 13 13 13 13 13 19 13 13 19 13 13 19 19 13 13 41 41 13 13 19 13 13 13 13 13 19 13 13 13 13 13 13 13 19 19 13 13 13 13 13 13 13 13 13 24 10 10 10 10 10 10 10 10 23 13 19 24 16 10 10 10 10 10 10 10 2 10 10 2 10 10 2 10 10 10 10 10 10 10 2 16 10 10 10 10 10 10 10 2 10 10 10 10 10 11 
11 13 13 19 13 13 19 13 19 13 13 13 13 13 13 13 13 13 13 13 41 41 13 13 13 13 13 19 13 19 13 13 19 13 19 13 13 13 13 13 13 13 19 13 13 19 13 13 19 24 10 10 16 10 10 10 10 10 23 13 13 24 2 10 10 10 10 10 10 10 10 10 10 10 10 2 16 10 16 10 10 10 10 10 2 10 10 10 2 10 16 10 10 2 10 10 10 10 10 11 
11 19 13 13 13 13 13 13 19 13 19 13 19 13 13 19 13 19 13 13 41 41 13 13 19 13 13 13 13 19 13 13 13 13 13 13 13 13 13 13 19 13 13 13 13 13 13 13 13 24 10 10 10 10 16 10 10 10 23 19 13 24 2 10 10 10 10 10 10 10 10 10 2 10 10 10 16 10 10 2 10 2 2 10 10 10 10 10 10 10 2 10 10 16 16 10 10 2 10 11 
11 13 13 19 13 13 19 13 13 13 13 13 13 13 13 13 13 13 13 13 41 41 13 13 13 13 13 13 13 13 13 13 13 13 13 13 19 13 13 13 13 19 13 13 13 13 13 19 13 24 10 10 10 10 16 10 10 10 25 26 26 27 10 10 10 10 10 10 10 16 10 10 2 10 10 10 2 10 10 2 10 10 10 10 10 2 2 2 10 10 10 2 10 10 10 10 10 2 2 11 
11 13 19 13 13 19 13 13 13 19 19 13 13 19 13 19 13 13 13 13 41 41 13 13 13 13 19 13 13 19 13 13 13 19 13 13 13 13 13 13 13 19 13 19 19 13 13 13 13 24 10 10 10 10 10 10 10 10 10 10 10 16 10 10 16 10 10 10 10 10 10 10 10 10 10 10 2 10 2 2 10 2 2 2 16 16 10 10 10 10 10 2 10 10 10 10 10 10 10 11 
11 19 13 13 13 13 13 19 19 19 13 13 13 19 13 13 13 19 13 13 41 41 13 13 13 19 13 13 13 13 13 13 13 13 19 19 13 13 19 13 13 19 13 13 13 13 13 13 13 24 10 10 10 10 10 16 10 10 10 10 10 10 10 10 10 10 10 10 10 10 2 10 10 10 2 10 10 10 2 2 2 2 10 10 10 10 10 10 10 10 10 10 10 10 16 16 10 10 10 11 
11 13 13 13 19 13 13 13 19 13 13 13 13 13 13 19 13 13 13 13 41 41 13 13 13 13 13 13 13 13 13 13 19 13 13 13 13 13 13 19 13 13 19 19 13 13 13 19 13 24 10 10 10 10 10 10 10 10 10 10 10 16 10 16 10 10 10 10 10 2 2 10 10 2 2 10 2 10 16 10 10 10 10 10 10 16 2 10 10 10 10 10 10 10 10 16 16 10 10 11 
11 35 35 35 35 35 35 35 35 35 35 35 35 35 35 35 35 35 35 35 34 34 35 35 35 35 35 35 35 35 13 13 19 13 13 13 13 13 13 13 13 13 13 13 13 13 19 13 13 24 10 16 10 10 10 10 10 10 16 10 10 10 10 10 10 10 10 10 10 2 10 10 10 10 2 16 2 10 2 10 10 10 2 10 10 10 10 10 10 16 10 10 2 10 10 2 10 10 10 11 
11 34 34 34 34 34 34 34 34 34 34 34 34 34 34 34 34 34 34 34 34 34 34 34 34 34 34 34 34 40 13 13 13 13 13 13 13 13 13 13 19 13 19 13 13 13 13 13 13 24 10 10 10 10 10 10 10 10 10 10 10 10 10 10 10 10 10 10 16 16 10 10 10 10 10 10 10 10 2 2 2 10 10 2 10 10 10 2 2 10 10 2 2 10 10 10 2 10 10 11 
11 34 34 34 34 34 34 34 34 34 34 34 34 34 34 34 34 34 34 34 34 34 34 34 34 34 34 34 34 40 13 19 13 13 13 13 19 13 13 13 13 13 19 19 13 13 19 13 13 24 10 10 10 10 10 10 10 10 10 10 10 10 16 10 10 10 10 16 10 10 10 10 10 10 10 10 10 10 2 10 16 10 10 10 10 10 10 10 10 10 10 10 10 10 10 10 2 10 10 11 
11 34 34 34 34 34 34 34 34 34 34 34 34 34 34 34 34 34 34 34 34 34 34 34 34 34 34 34 34 40 13 13 13 13 13 13 13 28 26 26 26 26 26 26 26 26 26 26 26 27 10 10 10 10 10 16 10 10 10 10 10 10 10 10 10 2 10 10 10 10 10 10 2 10 10 10 10 10 2 10 10 10 2 10 2 2 10 2 2 2 10 10 10 10 16 10 10 10 10 11 
11 34 34 34 34 34 34 34 34 34 34 34 34 34 34 34 34 34 34 34 34 34 34 34 34 34 34 34 34 40 13 13 19 13 13 13 13 24 10 10 10 10 10 16 10 10 10 16 16 10 10 10 10 10 10 16 10 10 10 10 10 10 2 2 16 10 10 10 10 10 10 10 2 2 10 10 10 10 2 16 16 10 10 10 10 16 10 2 10 10 10 2 2 2 10 10 10 10 10 11 
11 34 34 34 34 34 34 34 34 34 34 34 34 34 34 34 34 34 34 34 34 34 34 34 34 34 34 34 34 40 13 13 13 13 19 13 13 24 10 10 10 10 10 10 10 10 2 10 10 10 10 10 2 2 10 10 16 10 10 10 10 10 10 10 10 10 10 10 10 10 10 10 16 16 10 10 10 2 2 10 2 2 10 10 10 10 10 2 10 10 10 10 10 16 2 2 10 10 10 11 
11 34 34 34 34 34 34 34 34 34 34 34 34 34 34 34 34 34 34 34 34 34 34 34 34 34 34 34 34 40 13 13 19 13 13 13 13 24 10 10 10 10 10 2 10 10 2 10 10 10 10 10 10 10 2 2 2 10 10 10 10 10 10 10 10 16 10 10 10 10 2 10 10 10 10 16 10 2 10 2 2 10 10 10 10 10 10 10 10 16 10 2 2 2 2 10 10 10 2 11 
11 34 34 34 34 34 34 34 34 34 34 34 34 34 34 34 34 34 34 34 34 34 34 34 34 34 34 34 34 40 13 13 19 19 13 19 13 24 16 2 10 10 10 10 16 10 10 10 10 10 10 10 10 10 10 10 10 10 10 2 10 10 10 10 10 10 10 10 10 10 2 10 10 10 2 2 10 10 10 2 10 10 16 16 10 10 10 2 10 10 10 10 10 10 10 10 10 2 10 11 
11 34 34 34 34 34 34 34 34 34 34 34 34 34 34 34 34 34 34 34 34 34 34 34 34 34 34 34 34 40 13 13 13 19 13 13 13 24 10 10 10 10 10 10 16 10 10 10 10 10 10 10 2 10 10 10 16 10 2 10 10 10 16 10 10 10 10 10 10 10 10 2 16 10 10 2 2 10 2 2 10 10 10 10 2 10 10 2 2 10 10 10 10 10 10 10 10 2 10 11 
11 34 34 34 34 34 34 34 34 34 34 34 34 34 34 34 34 34 34 34 34 34 34 34 34 34 34 34 34 40 19 13 13 13 13 13 13 24 10 16 10 10 2 10 2 2 2 2 2 10 2 10 16 16 10 10 10 10 10 10 10 10 16 10 10 10 16 10 16 10 10 2 10 10 10 10 10 10 10 10 10 16 10 10 2 2 10 10 10 10 10 10 16 2 10 10 10 10 10 11 
11 34 34 34 34 34 34 34 34 34 34 34 34 34 34 34 34 34 34 34 34 34 34 34 34 34 34 34 34 40 13 13 13 13 13 13 13 24 16 16 10 10 10 10 10 10 10 2 10 10 10 10 10 10 10 2 10 10 10 10 10 10 10 10 10 10 10 10 10 10 10 10 10 10 10 10 10 10 10 10 10 10 10 10 10 2 2 16 2 10 16 10 10 2 2 10 10 16 10 11 
11 34 34 34 34 34 34 34 34 34 34 34 34 34 34 34 34 34 34 34 34 34 34 34 34 34 34 34 34 40 13 13 13 19 13 13 13 24 10 10 10 2 2 10 10 10 2 10 16 10 16 16 10 2 2 10 10 10 10 10 10 2 10 10 10 10 10 10 10 2 10 10 10 10 10 2 2 10 10 10 10 10 2 10 10 10 10 10 10 10 10 10 10 10 2 10 10 10 10 11 
11 34 34 34 34 34 34 34 34 34 34 34 34 34 34 34 34 34 34 34 34 34 34 34 34 34 34 34 34 40 13 13 13 13 13 13 19 24 10 10 10 10 2 2 2 10 10 2 10 10 10 10 10 2 2 10 10 10 10 10 10 16 10 10 10 10 2 10 10 10 10 2 10 10 10 16 2 2 2 10 10 10 10 2 10 10 10 10 10 10 10 10 10 10 10 10 10 10 10 11 
11 34 34 34 34 34 34 34 34 34 34 34 34 34 34 34 34 34 34 34 34 34 34 34 34 34 34 34 34 40 13 13 13 13 13 13 13 24 10 10 10 10 10 10 2 16 10 2 2 16 10 10 10 10 10 10 10 2 2 2 2 10 10 10 10 10 10 10 10 10 10 10 10 10 10 16 10 10 10 10 20 21 21 21 21 21 21 21 21 21 21 21 21 21 21 21 22 10 10 11 
11 34 34 34 34 34 34 34 34 34 34 34 34 34 34 34 34 34 34 34 34 34 34 34 34 34 34 34 34 40 19 13 13 13 13 19 13 24 10 10 10 10 10 10 10 10 10 10 2 10 10 10 10 10 10 2 2 10 2 10 2 2 10 10 10 10 10 10 2 10 10 10 10 10 16 2 10 2 10 10 25 29 13 19 13 13 13 13 19 13 19 13 19 13 13 13 19 22 16 11 
11 34 34 34 34 34 34 34 34 34 34 34 34 34 34 34 34 34 34 34 34 34 34 34 34 34 34 34 34 40 13 13 13 19 13 13 13 24 10 10 10 10 10 10 10 10 10 10 2 10 10 10 10 10 10 10 2 10 10 10 16 10 10 10 10 10 10 10 10 10 2 10 10 10 2 2 10 2 10 2 10 25 19 13 19 13 19 13 19 13 13 19 13 13 19 13 13 24 16 11 
11 34 34 34 34 34 34 34 34 34 34 34 34 34 34 34 34 34 34 34 34 34 34 34 34 34 34 34 34 40 13 13 13 13 13 13 13 24 10 2 2 10 16 10 10 10 10 10 10 10 10 10 10 10 10 10 2 10 10 10 10 10 10 10 10 10 10 10 10 10 10 10 10 10 10 2 10 10 10 10 10 10 25 29 13 13 13 13 13 13 13 13 13 13 13 13 13 24 16 11 
11 34 34 34 34 34 34 34 34 34 34 34 34 34 34 34 34 34 34 34 34 34 34 34 34 34 34 34 34 40 19 19 13 13 13 19 19 24 10 10 10 10 10 10 10 10 10 10 2 2 10 2 10 10 10 16 10 10 10 10 10 10 2 10 10 10 10 2 10 10 10 2 10 10 10 10 10 2 2 10 2 10 10 25 19 19 13 19 13 19 13 19 19 13 19 13 19 24 16 11 
11 34 34 34 34 34 34 34 34 34 34 34 34 34 34 34 34 34 34 34 34 34 34 34 34 34 34 34 34 40 13 13 13 13 13 13 13 24 10 10 10 10 10 10 10 10 10 10 16 2 2 10 10 10 10 10 10 10 2 16 10 10 10 10 10 10 10 10 10 10 10 10 10 10 2 2 10 10 10 16 10 10 10 10 25 26 26 26 26 26 26 26 26 26 26 26 26 27 16 11 
11 34 34 34 34 34 34 34 34 34 34 34 34 34 34 34 34 34 34 34 34 34 34 34 34 34 34 34 34 40 13 19 13 13 13 19 13 24 10 10 10 10 16 10 2 10 10 10 16 10 10 10 10 2 10 10 10 10 10 16 10 10 10 10 10 10 10 10 2 10 10 10 10 16 16 16 16 16 16 16 16 16 16 16 16 16 16 16 16 16 16 16 16 16 16 16 16 16 16 11 
11 34 34 34 34 34 34 34 34 34 34 34 34 34 34 34 34 34 34 34 34 34 34 34 34 34 34 34 34 40 13 13 13 13 13 19 13 24 10 10 10 10 10 10 10 10 10 10 10 10 10 10 10 10 10 10 10 10 10 10 10 10 10 10 10 10 10 10 10 10 10 10 10 20 21 21 21 22 16 16 16 16 16 16 16 16 16 16 16 16 16 16 16 16 16 16 16 16 16 11 
11 34 34 34 34 34 34 34 34 34 34 34 34 34 34 34 34 34 34 34 34 34 34 34 34 34 34 34 34 40 13 13 19 13 13 13 13 24 16 10 16 10 10 16 10 10 10 10 10 10 10 10 10 10 10 10 10 10 10 10 10 10 10 2 10 10 10 16 16 16 16 16 20 31 13 13 13 24 16 16 16 16 16 16 16 16 16 16 16 16 16 16 16 16 16 16 16 16 16 11 
11 42 42 42 42 42 42 42 42 42 42 42 42 42 42 42 42 42 42 42 42 42 42 42 42 42 42 42 42 42 13 13 13 19 13 13 13 24 10 10 10 10 10 10 10 10 16 10 10 10 2 10 10 10 10 10 2 10 10 10 16 10 10 10 10 10 16 16 16 16 16 16 23 19 13 19 19 24 20 22 16 16 16 16 16 16 16 16 16 16 16 16 16 16 16 16 16 16 16 11 
11 13 13 13 13 13 19 13 13 13 13 13 13 13 13 13 13 13 13 13 13 13 13 13 19 13 13 13 13 13 13 13 13 13 13 19 13 24 16 10 10 16 10 10 10 10 10 10 10 10 10 10 10 10 10 10 2 10 10 10 10 10 10 10 10 10 16 16 16 16 16 16 23 13 13 13 13 24 25 27 16 16 16 16 16 16 16 16 16 16 16 16 16 16 16 16 16 16 16 11 
11 13 13 13 13 19 13 13 13 13 19 13 13 19 13 13 19 13 13 13 19 13 13 13 13 13 13 13 19 13 19 13 13 13 19 13 13 24 10 10 16 10 10 10 16 10 16 2 10 10 10 2 10 10 10 10 10 10 2 10 10 10 10 10 10 16 16 16 16 16 16 16 23 19 13 13 19 30 21 22 16 16 16 16 16 16 16 16 16 16 16 16 16 16 16 16 16 16 16 11 
11 13 13 13 13 13 13 19 13 13 19 19 13 13 13 13 13 13 13 13 13 13 13 13 13 19 13 13 13 13 13 13 13 13 13 13 13 24 10 10 10 10 10 10 10 10 10 10 10 10 10 2 2 10 10 10 10 10 10 10 2 10 10 10 16 16 16 16 16 16 16 16 25 26 26 26 26 26 26 27 16 16 16 16 16 16 16 16 16 16 16 16 16 16 16 16 16 16 16 11 
11 13 19 13 19 19 13 13 13 19 13 13 13 13 19 13 13 13 19 13 13 13 19 13 13 13 13 13 19 13 13 13 19 13 13 19 19 24 10 10 10 10 10 10 10 10 10 10 10 10 2 10 10 10 10 10 10 10 10 10 16 10 10 10 16 16 16 16 16 16 16 16 16 16 16 16 16 16 16 16 16 16 16 16 16 16 16 16 16 16 16 16 16 16 16 16 16 16 16 11 
11 13 13 13 13 13 13 13 19 13 13 13 19 13 13 13 13 13 13 13 19 13 13 13 13 13 13 13 19 13 13 13 19 13 13 13 13 24 16 10 10 16 10 10 10 16 10 10 10 2 2 10 10 2 10 10 2 10 10 16 10 10 10 16 16 16 16 16 16 16 16 16 16 16 16 16 16 16 16 16 16 16 16 16 16 16 16 16 16 16 16 16 16 16 16 16 16 16 16 11 
11 13 19 13 13 13 19 13 13 19 13 13 13 13 19 13 19 13 19 13 13 13 19 13 13 19 13 13 13 13 13 19 13 13 19 13 13 24 10 10 16 10 10 16 10 10 10 10 10 2 10 10 10 16 16 16 16 16 16 16 16 16 16 16 16 16 16 16 16 16 16 16 16 16 16 16 16 16 16 16 16 16 16 16 16 16 16 16 16 16 16 16 16 16 16 16 16 16 16 11 
11 13 13 19 13 13 13 13 13 13 13 19 13 13 13 13 13 13 13 19 13 19 13 13 13 13 13 13 19 13 19 13 13 13 13 13 13 24 16 10 10 10 10 10 10 10 10 10 2 10 10 16 16 16 16 16 16 16 16 16 16 16 16 16 16 16 16 16 16 16 16 16 16 16 16 16 16 16 16 16 16 16 16 16 16 16 16 16 16 16 16 16 16 16 16 16 16 16 16 11 
11 26 26 26 26 26 26 26 26 26 26 26 26 26 26 26 26 26 26 26 26 26 26 26 26 26 26 26 26 26 26 26 26 26 26 26 26 27 10 10 10 10 10 10 10 10 16 16 16 16 16 16 16 16 16 16 16 16 16 16 16 16 16 16 16 16 16 11 11 11 11 11 11 11 11 11 11 11 11 11 11 11 11 11 11 11 11 11 11 11 11 11 11 11 11 11 11 11 11 11 
11 10 10 10 10 10 10 10 10 10 10 10 10 10 10 10 10 10 10 10 10 10 10 10 10 10 16 10 10 2 10 10 10 10 10 16 10 10 2 10 16 10 10 2 16 16 16 16 16 16 16 16 16 16 16 16 16 16 16 16 16 16 16 16 16 16 16 11 2 10 10 2 10 10 10 10 10 10 10 10 10 10 11 10 11 10 11 10 10 10 10 10 10 10 10 10 10 10 10 11 
11 10 10 10 10 10 10 10 10 10 10 10 10 16 10 10 10 10 16 10 10 10 16 10 10 16 10 10 10 10 10 10 10 10 10 10 10 10 16 10 10 10 16 16 16 16 16 16 16 16 16 16 16 16 16 16 16 16 16 16 16 16 16 16 16 16 16 11 2 11 11 11 11 11 11 11 11 11 11 11 11 11 11 10 11 10 11 10 11 11 11 11 11 11 11 11 11 11 10 11 
11 10 10 2 10 2 10 10 10 10 10 10 10 10 10 2 10 2 10 10 10 16 10 10 10 10 10 16 10 10 10 10 10 16 10 10 16 10 10 10 2 10 16 16 16 16 16 16 16 16 16 16 16 16 16 16 16 16 16 16 16 16 16 16 16 16 16 11 10 11 10 10 10 10 10 10 11 10 10 10 10 10 10 10 11 10 10 10 11 10 10 10 10 11 10 10 10 11 10 11 
11 10 10 2 10 2 10 16 10 10 10 10 10 10 10 2 10 10 10 10 10 10 10 16 10 16 10 10 10 10 10 10 2 2 10 2 10 10 2 10 10 10 16 16 16 16 16 16 16 16 16 16 16 16 16 16 16 16 16 16 16 16 16 16 16 16 16 11 10 11 10 11 11 11 11 11 11 10 11 11 11 11 11 10 11 10 11 10 11 10 11 11 11 11 11 11 10 11 10 11 
11 10 10 16 10 10 10 10 10 10 10 10 16 10 10 10 10 16 16 2 10 16 10 10 10 10 10 16 10 10 10 10 10 10 16 2 2 16 10 10 2 10 10 16 16 16 16 16 16 16 16 16 16 16 16 16 16 16 16 16 16 16 16 16 16 16 16 11 2 11 10 11 10 11 10 10 10 10 10 10 10 10 11 10 11 10 11 2 11 10 11 10 10 10 10 11 10 11 10 11 
11 10 10 10 10 10 10 10 10 2 2 10 10 10 10 10 10 10 10 10 10 10 16 10 10 10 10 10 10 10 2 2 10 10 2 2 10 10 10 10 2 10 10 10 10 10 16 16 16 16 16 16 16 16 16 16 16 16 16 16 16 16 16 16 16 16 16 11 10 2 10 11 10 11 11 11 11 11 11 11 11 10 11 10 11 10 11 2 11 10 11 10 11 10 10 11 10 10 10 11 
11 10 10 10 10 10 10 10 16 10 10 16 10 10 10 10 10 2 10 10 16 10 10 10 2 16 10 16 10 10 16 2 10 2 10 10 16 10 10 2 10 10 10 2 2 2 2 10 16 16 16 16 16 16 16 16 16 16 16 16 16 16 16 16 16 16 16 11 10 11 10 11 10 11 10 10 10 10 11 16 11 10 11 10 11 2 11 10 10 10 11 10 11 10 10 11 10 11 11 11 
11 10 10 16 10 10 10 2 10 10 10 10 10 10 10 16 10 10 2 10 10 10 2 10 10 10 2 10 10 10 10 10 10 10 16 10 10 16 10 2 10 2 2 10 10 10 10 10 2 10 10 2 16 16 16 16 16 16 16 10 2 10 2 10 10 10 10 10 10 11 10 11 10 11 10 11 11 11 11 10 11 10 11 10 11 11 11 2 11 10 11 10 11 10 10 11 10 11 10 11 
11 10 10 2 10 10 10 2 10 10 10 10 10 10 16 10 2 10 2 10 2 10 10 16 10 10 10 10 10 10 10 10 16 16 16 16 16 10 16 16 10 2 10 10 10 10 2 10 10 10 10 10 2 2 10 10 10 10 10 10 10 10 10 16 16 16 16 11 10 11 10 11 10 11 10 11 10 10 10 10 10 10 11 10 10 10 10 10 11 10 11 10 11 10 10 11 10 11 10 11 
11 10 10 2 10 10 10 10 10 10 10 10 10 10 10 10 10 10 10 10 10 10 10 10 10 10 10 10 10 10 16 16 16 16 16 16 16 16 16 16 10 16 16 10 16 2 2 16 10 10 10 10 10 10 10 2 2 2 2 10 2 16 16 16 16 16 16 11 10 11 10 11 10 10 10 11 10 11 11 11 11 11 11 11 11 11 11 11 11 11 11 10 11 10 10 11 10 11 10 11 
11 10 10 2 2 10 10 10 10 16 10 10 10 10 10 10 10 2 16 10 10 2 10 10 16 10 10 10 16 10 10 16 16 16 16 16 16 16 16 16 16 16 16 16 16 16 16 16 16 16 16 16 16 16 10 10 10 10 10 10 16 16 16 16 16 16 16 11 10 11 10 11 10 11 10 11 10 10 10 10 11 10 11 10 10 10 10 10 10 10 10 10 11 2 2 11 10 11 10 11 
11 2 2 10 2 2 16 10 10 10 10 10 2 2 10 10 2 10 10 10 10 10 10 2 10 10 10 16 2 10 10 16 16 16 16 16 16 16 16 16 16 16 16 16 16 16 16 16 16 16 16 16 16 16 16 16 16 10 2 16 16 16 16 16 16 16 16 11 10 11 11 11 10 11 10 10 10 10 11 10 11 10 11 11 11 11 11 11 11 10 11 11 11 2 2 10 10 11 10 11 
11 10 16 10 10 10 10 10 10 2 10 10 10 10 10 10 16 10 10 10 10 10 10 10 10 16 10 10 2 10 10 16 16 16 16 16 16 16 16 16 16 16 16 16 16 16 16 16 16 16 16 16 16 16 16 16 16 16 16 16 16 16 16 16 16 16 16 11 10 11 10 11 11 11 11 11 11 10 11 10 11 10 10 10 10 10 11 10 10 10 11 19 13 19 13 11 10 11 10 11 
11 10 16 10 10 10 10 2 10 10 10 10 10 16 10 10 10 10 10 16 10 2 10 10 10 10 10 10 10 16 10 16 16 16 16 16 16 16 16 16 16 16 16 16 16 16 16 16 16 16 16 16 16 16 16 16 16 16 16 16 16 16 16 16 16 16 16 11 10 11 10 10 10 10 10 10 10 10 11 10 11 10 11 10 13 13 11 10 11 10 11 13 19 13 19 11 10 11 10 11 
11 10 10 10 2 2 10 10 10 10 10 2 2 2 10 10 10 10 16 10 10 2 10 10 10 10 10 16 10 10 10 16 16 16 16 16 16 16 16 16 16 16 16 16 16 16 16 16 16 16 16 16 16 16 16 16 16 16 16 16 16 16 16 16 16 16 16 11 10 11 11 11 11 11 11 11 11 11 11 10 11 10 11 10 11 11 11 10 11 10 11 11 11 11 11 11 11 11 10 11 
11 10 10 10 10 10 10 10 16 10 10 10 10 16 10 10 10 10 10 10 10 10 10 10 10 10 10 10 10 10 10 16 16 16 16 16 16 16 16 16 16 16 16 16 16 16 16 16 16 16 16 16 16 16 16 16 16 16 16 16 16 16 16 16 16 16 16 11 10 10 10 10 10 10 10 10 10 10 10 10 11 10 11 10 10 10 10 10 11 10 10 10 10 10 10 10 10 10 10 11 
11 11 11 11 11 11 11 11 11 11 11 11 11 11 11 11 11 11 11 11 11 11 11 11 11 11 11 11 11 11 11 11 11 11 11 11 11 11 11 11 11 11 11 11 11 11 11 11 11 11 11 11 11 11 11 11 11 11 11 11 11 11 11 11 11 11 11 11 11 11 11 11 11 11 11 11 11 11 11 11 11 11 11 11 11 11 11 11 11 11 11 11 11 11 11 11 11 11 11 11 
